SrI	vrtta	G
strI	vrtta	GG
nArI	vrtta	GGG
mfgI	vrtta	GLG
kanyA	vrtta	GGGG
paNkti	vrtta	GLLGG
tanumaDyA	vrtta	GGLLGG
SaSivadanA	vrtta	LLLLGG
vasumatI	vrtta	GGLLLG
maDumatI	vrtta	LLLLLLG
madaleKA	vrtta	GGGLLGG
kumAralalitA	vrtta	LGLLLGG
haMsamAlA	vrtta	LLGGLGG
vidyunmAlA	vrtta	GGGG|GGGG
citrapadA	vrtta	GLLGLLGG
mARavaka	vrtta	GLLGGLLG
haMsaruta	vrtta	GGGLLLGG
samAnikA	vrtta	GLGLGLGL
pramARikA	vrtta	LGLGLGLG
campakamAlA	vrtta	GLLGGGLLGG
nArAcaka	vrtta	GGLGLGLG
halamuKI	vrtta	GLGLLLLLG
BujagaSiSuBftA	vrtta	LLLLLLG|GG
SudDavirAw	vrtta	GGGLLGLGLG
paRava	vrtta	GGGLL|LLGGG
mayUrasAriRI	vrtta	GLGLGLGLGG
rukmavatI	vrtta	GLLGGGLLGG
mattA	vrtta	GGGG|LLLLGG
manoramA	vrtta	LLLGLGLGLG
upasTitA	vrtta	GG|LLGLLGLG
indravajrA	vrtta	GGLGGLLGLGG
upendravajrA	vrtta	LGLGGLLGLGG
sAndrapada	vrtta	GLLGGLLLLGG
sumuKI	vrtta	LLLLG|LLGLLG
doDaka	vrtta	GLLGLLGLLGG
SAlinI	vrtta	GGGG|GLGGLGG
vAtormI	vrtta	GGGG|LLGGLGG
BramaravilasitaM	vrtta	GGGG|LLLLLLG
SrI	vrtta	GLLGG|LLLLGG
raTodDatA	vrtta	GLGLLLGLGLG
svAgatA	vrtta	GLGLLLGLLGG
vfntA	vrtta	LLLL|LLLLGGG
BadrikA	vrtta	LLLLLLGLGLG
SyenikA	vrtta	GLGLGLGLGLG
upasTita	vrtta	LGLLLGGGLGG
SiKaRqita	vrtta	LGLLLGGGLGG
mOktikamAlA	vrtta	GLLGLLGGLLG
candravartma	vrtta	GLGLLLGLLLLG
vaMSasTa	vrtta	LGLGGLLGLGLG
indravaMSA	vrtta	GGLGGLLGLGLG
towaka	vrtta	LLGLLGLLGLLG
drutavilambita	vrtta	LLLGLLGLLGLG
puwa	vrtta	LLLLLLGGGLGG
pramuditavadanA	vrtta	LLLLLLGLGGLG
mOktidadAma	vrtta	LGLLGLLGLLGL
kusumavicitrA	vrtta	LLLLGG|LLLLGG
jalodDatagati	vrtta	LGLLLGLGLLLG
BujaNgaprayAta	vrtta	LGGLGGLGGLGG
sragviRI	vrtta	GLGGLGGLGGLG
priyaMvadA	vrtta	LLLGLLLGLGLG
maRimAlA	vrtta	GGLLGGGGLLGG
lalitA	vrtta	GGLGLLLGLGLG
pramitAkzarA	vrtta	LLGLGLLLGLLG
ujjvalA	vrtta	LLLLLLGLLGLG
vESvadevI	vrtta	GGGGG|GLGGLGG
jalaDaramAlA	vrtta	GGGG|LLLLGGGG
navamAlinI	vrtta	LLLL|GLGLLLGG
praBA	vrtta	LLLLLLGLGGLG
mAlatI	vrtta	LLLLGLLGLGLG
paYcacAmara	vrtta	LGLGLGLGLGLG
tAmarasa	vrtta	LLLLGLLGLLGG
kzamA	vrtta	LLLLLLGGLGGLG
praharziRI	vrtta	GGGLLLLGLGLGG
rucirA	vrtta	LGLGLLLLGLGLG
mattamayUra	vrtta	GGGG|GLLGGLLGG
maYjuBAziRI	vrtta	LLGLGLLLGLGLG
nandinI	vrtta	LLGLGLLLGLLGG
candrikA	vrtta	LLLL|LLGGLGLGG
asambADA	vrtta	GGGGG|LLLLLLGGG
aparAjitA	vrtta	LLLLLLG|LGLLGLG
praharaRakalikA	vrtta	LLLLLLG|LLLLLLG
vasantatilakA	vrtta	GGLGLLLGLLGLGG
induvadanA	vrtta	GLLLGLLLGLLLGG
alolA	vrtta	GGGLLGG|GGGLLGG
SaSikalA	vrtta	LLLLLLL|LLLLLLLG
mAlA	vrtta	LLLLLL|LLLLLLLLG
maRiguRanikara	vrtta	LLLLLLLL|LLLLLLG
malinI	vrtta	LLLLLLGG|GLGGLGG
praBadraka	vrtta	LLLLGLGLLLGLGLG
elA	vrtta	LLGLG|LLLLLLLLGG
candraleKA	vrtta	GGGGLGG|GGLGGLGG
fzaBagajavilasita	vrtta	GLLGLG|LLLLLLLLLG
vARinI	vrtta	LLLLGLGLLLGLGLGG
SiKariRI	vrtta	LGGGGG|LLLLLGGLLLG
pfTvI	vrtta	LGLLLGLG|LLLGLGGLG
vaMSapatrapatitam	vrtta	GLLGLGLLLGLL|LLLLG
hariRI	vrtta	LLLLLG|GGGG|LGLLGLG
mandAkrAntA	vrtta	GGGG|LLLLLG|GLGGLGG
narkuwaka	vrtta	LLLLGLGLLLGLLGLLG
kokilaka	vrtta	LLLLGLG|LLLGLL|GLLG
kusumitalatAvellitA	vrtta	GGGGG|LLLLLG|GLGGLGG
meGavisPurjita	vrtta	LGGGGG|LLLLLG|GLGGLGG
SArdulavikrIqita	vrtta	GGGLLGLGLLLG|GGLGGLG
suvadanA	vrtta	GGGGLGG|LLLLLLG|GGLLLG
vftta	vrtta	GLGLGLGLGLGLGLGLGLGL
sragDarA	vrtta	GGGGLGG|LLLLLLG|GLGGLGG
madraka	vrtta	GLLGLGLLLG|LGLLLGLGLLLG
aSvalalita	vrtta	LLLLGLGLLLG|LGLLLGLGLLLG
mattAkrIqa	vrtta	GGGGGGGG|LLLLL|LLLLLLLLLG
tanvI	vrtta	GLLGG|LLLLLLG|GLLGLLLLLLGG
krOYcapadA	vrtta	GLLGG|GLLGGLLL|LLLLLLL|LLLLG
BujaNgavijfmBita	vrtta	GGGGGGGG|LLLLLLLLLLG|LGLLGLG
apavAha	vrtta	GGGLLLLLL|LLLLLL|LLLLLL|LLGGG
caRqavfzwiprayAtadaRqaka	vrtta	LLLLLLGLGGLGGLGGLGGLGGLGGLG
arRadaRqaka	vrtta	LLLLLLGLGGLGGLGGLGGLGGLGGLGGLG
arRavadaRqaka	vrtta	LLLLLLGLGGLGGLGGLGGLGGLGGLGGLGGLG
vyAladaRqaka	vrtta	LLLLLLGLGGLGGLGGLGGLGGLGGLGGLGGLGGLG
jImUtadaRqaka	vrtta	LLLLLLGLGGLGGLGGLGGLGGLGGLGGLGGLGGLGGLG
lIlAkaradaRqaka	vrtta	LLLLLLGLGGLGGLGGLGGLGGLGGLGGLGGLGGLGGLGGLG
uddAmadaRqaka	vrtta	LLLLLLGLGGLGGLGGLGGLGGLGGLGGLGGLGGLGGLGGLGGLG
SaNKadaRqaka	vrtta	LLLLLLGLGGLGGLGGLGGLGGLGGLGGLGGLGGLGGLGGLGGLGGLG
samudradaRqaka	vrtta	LLLLLLGLGGLGGLGGLGGLGGLGGLGGLGGLGGLGGLGGLGGLGGLGGLG
BujaNgadaRqaka	vrtta	LLLLLLGLGGLGGLGGLGGLGGLGGLGGLGGLGGLGGLGGLGGLGGLGGLGGLG
pracitakadaRqaka	vrtta	LLLLLLLGGLGGLGGLGGLGGLGGLGG
upacitrA	vrtta	LLGLLGLLGLG/GLLGLLGLLGG
drutamaDyA	vrtta	GLLGLLGLLGG/LLLLGLLGLLGG
vegavatI	vrtta	LLGLLGLLGLLGG/GLLGLLGLLGG
BadravirAw	vrtta	GGLLGLGLGG/GGGLLGLGLG
ketumatI	vrtta	LLGLGLLLGG/GLLGLGLLLGG
AKyAnikI	vrtta	GGLGGLLGLGG/LGLGGLLGLGG
viparItAKyAnikI	vrtta	LGLGGLLGLGG/GGLGGLLGLGG
hariRaplutA	vrtta	LLGLLGLLGLG/LLLGLLGLLGLG
aparavaktra	vrtta	LLLLLLGLGLG/LLLLGLLGLGLG
puzpitAgrA	vrtta	LLLLLLGLGLGG/LLLLGLLGLGLGG
yavAtparAmatIya	vrtta	GLGLGLGLGLGL/LGLGLGLGLGLG
ApIqa	vrtta	LLLLLLGG/LLLLLLLLLLGG/LLLLLLLLLLLLLLGG/LLLLLLLLLLLLLLLLLLGG
kalikA	vrtta	LLLLLLLLLLGG/LLLLLLGG/LLLLLLLLLLLLLGG/LLLLLLLLLLLLLLLLLLGG
lavalI	vrtta	LLLLLLLLLLGG/LLLLLLLLLLLLLLGG/LLLLLLGG/LLLLLLLLLLLLLLLLLLGG
amftaDArA	vrtta	LLLLLLLLLLGG/LLLLLLLLLLLLLLGG/LLLLLLLLLLLLLLLLLLGG/LLLLLLGG
udgatA	vrtta	LLGLGLLLGL/LLLLLGLGLG/GLLLLLLGLLG/LLGLGLLLGLGLG
sOraBaka	vrtta	LLGLGLLLGL/LLLLLGLGLG/GLGLLLGLLG/LLGLGLLLGLGLG
lalita	vrtta	LLGLGLLLGL/LLLLLGLGLG/LLLLLLLLGLLG/LLGLGLLLGLGLG
upasTitapracupita	vrtta	GGGLLGLGLGLLGG/LLGLLLLGLGLGG/LLLLLLLLG/LLLLLLLLLLGLLGG
varDamAna	vrtta	GGGLLGLGLGLLGG/LLGLLLLGLGLGG/LLLLLGLLL/LLLLLLLLLLGLLGG
SudDavirAqArzaBa	vrtta	GGGLLGLGLGLLGG/LLGLLLLGLGLGG/GGLLGLGLG/LLLLLLLLLLGLLGG
